R200 200
NOtextures/nice.png
SOtextures/wall_south.png
WEtextures/wall_west.png
EAtextures/wall_east.png
Stextures/sprite.png
F50,0,0
C5,9,50


11111111111111111111111111111111111111111111111111111111111
10000000000000000000000000000000000000000000000000000000001
10000020000W00000000000000000000000000000000000000000000001
10000000000000000000000000000000000000000000000000000000001
10000000000000000000000000000000000000000000000000000000001
11111111111111111111111111111111111111111111111111111111111

