R 1280 640

NO ./img/cobblestone.png
EA ./img/cobblestone.png
SO ./img/cobblestone.png
WE ./img/cobblestone.png

S ./img/thenun.png
F ./img/basalt.png
C ./img/basalt.png

11111111111111111111111111
13330000001200001000000001
13331111101111101110111011
13331000101002101000120011
11111010101011101011111011
10021010001000000011210011
10111011101111111111010111
10021010001000000021000111
10111011111010111111011111
10000003000010000100010001
10111110111111110101110101
10100010000012000101000101
10101011111011111101011101
10001210301000002101000101
10101110101110111101110101
10100000101210000001000101
10111111101011111111011101
10001000001000100011002101
11101011111010101011111101
10001000000010301000000001
10111111101111101111111111
1000100000100W130000000021
11101010111011111010101111
12001210021030303013100021
11111111111111111111111111