R 1280 720

NO ./img/cobblestone.png
EA ./img/cobblestone.png
SO ./img/cobblestone.png
WE ./img/cobblestone.png

F 50,50,50
C 100,100,240
S ./img/thenun.png

111111
100001
100011
100W1
120011
111111
