R 1280 720

NO ./img/cobblestone.png
EA ./img/cobblestone.png
SO ./img/cobblestone.png
WE ./img/cobblestone.png

F 50,50,50
C 100,100,240
S ./img/thenun.png

1111111
1000001
100001
100W011
1000001
1111111
