R 1280 640

NO ./img/cobblestone.png
EA ./img/cobblestone.png
SO ./img/cobblestone.png
WE ./img/cobblestone.png

S ./img/thenun.png
F ./img/basalt.png
C ./img/basalt.png

11111111111111111111111111
1333      12    1        1
133311111 11111 111 111 11
13331   1 1  21 1   12  11
11111 1 1 1 111 1 11111 11
1  21 1 0 1       1121  11
1 111 111 1111111111 1 111
1  21 1   1       21   111
1 111 11111 1 111111 11111
1      3    1    1   1   1
1 11111 11111111 1 111 1 1
1 1   1     12   1 1   1 1
1 1 1 11111 111111 1 111 1 
1   121 3 1     21 1   1 1
1 1 111 1 111 1111 111 1 1
1 1     1 121      1   1 1
1 1111111 1 11111111 111 1
1   1     1   1   11  21 1
111 1 11111 1 1 1 111111 1
1   1       1 3 1        1
1 1111111 11111 1111111111
1   1     1  W13        21
111 1 1 111 11111 1 1 1111
12  121  21 3 3 3 131   21
11111111111111111111111111